9,8,
00,00,01,02,02,02,03,00,00,
00,01,04,05,05,05,06,03,00,
00,07,05,05,05,05,05,08,00,
00,07,0513,05,05,05,05,08,00,
00,07,05,05,05,05,05,08,00,
00,07,05,05,05,05,0514,08,00,
00,07,09,09,09,09,09,08,00,
00,10,11,11,11,11,11,12,00