8,9,
00,00,00,00,00,00,00,00,
00,01,07,07,07,07,07,10,
01,04,05,05,05,05,09,11,
02,05,05,05,05,05,09,11,
02,05,05,05,0005,05,09,11,
02,05,05,05,05,05,09,11,
03,06,05,05,05,0514,09,11,
00,03,08,08,08,08,08,12,
00,00,00,00,00,00,00,00